**.****..*.*...
*.*..*.*...*..*
*....*******.**
......*..**...*
**.*...*..*.*..
..*....**..**..
...***..*....**
*.*.*...*.***..
.......*....*..
.**...***..*.*.
*..*...*.....**
.**.***.*.*..*.
.....*****.*...
.***.***.**..*.
*..*....*.*****
...........*.**
...*.*.******.*
**.**.**.....**
.*.*.....**...*
*............*.
