***...*...**.****....**.*.*..*
.*.**....*...*...*..*.*.*..***
*..*****....*****.*.*...**.*..
.*...*.***...**.**.**..***.***
.*.*.****.*.**.*.*....*****..*
...**.**..*..*****..**...**..*
*.**..*..*.*...**..*..*..*..**
**...*...**.*.*..*.*..*..*...*
***.*.*......*....*..*..*.****
.*.*.**....**.....*.*...*.*.**
.*...*..****...****..***.*****
.**...*..*.**......*****.**..*
*.**.*.*.*.....*.*........*.*.
*.**..**....*...**..**..******
*..**.***..*.**.**.*..*******.
.*.....*.*.*.*.*.*****..***..*
***..**...*....**.**..*...****
.*.....****..*.**..**.*..*..*.
***.*....*..*.*.**.**.....**.*
*..*..**..*.*..**.........*.*.
